@Author Rupesh


Hello World, I wish you all a happy newer in 164 languages


In English: Happy New Year
In Afrikaans: gelukkige nuwejaar 
In Akposso: ilufio ètussé
In Albanian: Gëzuar vitin e ri
In Alsatian: e glëckliches nëies 
In Arabic sana saiida
In Armenian: shnorhavor nor tari
In Atikamekw: amokitanone
In Azeri: yeni iliniz mübarək
In Bambara: bonne année
In Basaa: mbuee
In Basque: urte berri on
In Belarusian: Z novym hodam
In Bengali: subho nababarsho
In Berber: asgwas amegas
In Beti: mbembe mbu
In Bhojpuri: nauka sal mubarak hoe
In Bobo: bonne année
In Bosnian: sretna nova godina
In Breton: bloavezh mat 
In Bulgarian: chestita nova godina
In Burmese: hnit thit ku mingalar pa
In Cantonese: sun lin fi lok 
In Catalan: bon any nou
In Mandarin: xin nian kuai le
In Cornish: bledhen nowedh da
In Corsican: pace è salute
In Croatian: sretna nova godina
In Czech: šťastný nový rok
In Danish: godt nytår
In Dari: sale naw tabrik
In Duala: mbu mwa bwam
In Dutch: gelukkig nieuwjaar
In Esperanto: feliĉan novan jaron
In Estonian: head uut aastat
In Ewe: eƒé bé dzogbenyui nami
In Ewondo: mbembe mbu
In Fang: bamba mbou
In Faroese: gott nýggjár
In Finnish: onnellista uutta vuotta
In Flemish: gelukkig nieuwjaar
In Fon: coudo we yoyo
In French: bonne année
In Frisian: lokkich neijier
In Friulan: bon an
In Fula: dioul mo wouri
In Galician: feliz ano novo
In Georgian: gilocavt akhal tsels
In German: Frohes neues Jahr 
In Greek: kali chronia 
In Gujarati: nootan varshabhinandan
In Guaraní: rogüerohory año nuévo-re
In Haitian creole: bònn ané
In Haoussa: barka da sabuwar shekara
In Hawaiian: hauoli makahiki hou
In Hebrew: shana tova
In Herero: ombura ombe ombua
In Hindi: nav varsh ki subhkamna
In Hmong: nyob zoo xyoo tshiab
In Hungarian: boldog új évet
In Icelandic: gleðilegt nýtt ár
In Igbo: obi anuri nke afor ohuru
In Indonesian: selamat tahun baru
In Irish Gaelic: ath bhliain faoi mhaise
In Italian: felice anno nuovo
In Javanese: sugeng warsa enggal
In Japanese: akemashite omedetô gozaimasu
In Kabylian: aseggas ameggaz
In Kannada: hosa varshada shubhaashayagalu
In Kashmiri: nav reh mubarakh
In Kazakh: zhana zhiliniz kutti bolsin
In Khmer: sur sdei chhnam thmei
In Kiembu: ngethi cya mwaka mweru
In Kinyarwanda: umwaka mwiza
In Kirundi: umwaka mwiza
In Korean: seh heh bok mani bat uh seyo
In Kurde: sala we ya nû pîroz be
In Kwangali: mvhura zompe zongwa
In Lao: sabai di pi mai
In Latin: felix sit annus novus
In Latvian: laimīgu Jauno gadu
In Ligurian: bón ànno nêuvo
In Lingala: bonana 
In Lithuanian: laimingų Naujųjų Metų
In Low saxon: gelükkig nyjaar
In Luganda: omwaka omulungi
In Luxembourgeois: e gudd neit Joër
In Macedonian: srekna nova godina
In Malagasy: arahaba tratry ny taona
In Malay: selamat tahun baru
In Malayalam: nava varsha ashamshagal
In Maltese: is-sena t-tajba
In Mangarevan: kia porotu te ano ou
In Maori: kia hari te tau hou
In Marathi: navin varshaachya hardik shubbheccha
In Marquisian: kaoha nui tenei ehua hou
In Mohawk: ose:rase
In Mongolian: shine jiliin bayariin mend hurgeye
In Moré: wênd na kô-d yuum-songo
In Ndebele: umyaka omucha omuhle
In Ngombale: ngeu’ shwi pong mbeo paghe
In Norman: boune anna
In Norwegian: godt nyttår
In Occitan: bon annada
In Oriya: subha nababarsa 
In Ourdou: naya sar Mubarak
In Palauan: ungil beches er rak
In Papiamentu: bon anja 
In Pashto: nawe kaalmo mobarak sha
In Persian: sâle no mobârak
In Polish: szczęśliwego nowego roku
In Portuguese: feliz ano novo
In Punjabi: nave saal deeyan vadhaiyaan
In Romanche: bun di bun onn
In Romani: baxtalo nevo bersh
In Romanian: un an nou fericit 
In Russian: S novim godom
In Samoan: ia manuia le tausaga fou
In Sami: buorre ådåjahke
In Sango: nzoni fini ngou
In Sardinian: bonu annu nou
In Scottish Gaelic: bliadhna mhath ur
In Serbian: Srećna Nova godina
In Shimaore: mwaha mwema
In Shona: goredzva rakanaka
In Sindhi: nain saal joon wadhayoon
In Sinhalese: shubha aluth awuruddak weiwa
In Slovak: šťastný nový rok
In Slovenian: srečno novo leto
In Sobota: dobir leto
In Somali: sanad wanagsan
In Spanish: feliz año nuevo
In Sranan: wan bun nyun yari
In Swahili: mwaka mzuri 
In Swedish: gott nytt år
In Swiss-German: es guets Nöis
In Tagalog: manigong bagong taon
In Tahitian: ia orana i te matahiti api
In Tamazight: assugas amegaz
In Tamil: iniya puthandu nal Vazhthukkal
In Tatar: yaña yıl belän
In Telugu: nuthana samvathsara subhakankshalu
In Thai: sawatdii pimaï
In Tibetan: tashi delek 
In Tigre: sanat farah wa khare
In Tshiluba: tshidimu tshilenga
In Tswana: itumelele ngwaga o mosha
In Tulu: posa varshada shubashaya
In Turkish: yeni yılınız kutlu olsun
In Twents: gluk in’n tuk
In Udmurt: Vyľ Aren
In Ukrainian: z novym rokom
In Urdu: naya sal Mubarak
In Uzbek: yangi yilingiz qutlug’ bo’lsin
In Vietnamese: Cung Chúc Tân Xuân
In Waloon: ene boune anéye, ene boune sintéye
In Welsh: blwyddyn newydd dda
In West indian creole: bon lanné
In Wolof: dewenati
In Xhosa: nyak’omtsha
In Yiddish: a gut yohr
In Yoruba: eku odun 
In Zerma: barka’n da djiri tagio
In Zulu: unyaka omusha omuhle


This was coded in python cheers and lets begin 2021 in style

